WBBWTTXW
M      X
M  M   W
M  M  DD
W  M  DD
W  M   W
W 1  2 W
WWWWWWWW