WTPMMPTW
M      M
X  MM  X
B  MM  B
B  MM  B
X  MM  X
M  12  M
WDDMMDDW