WWWWTTXW
M      X
B M    W
B M   DW
W M   DW
W M    W
W1   2 W
WWWWWWWW