WWWWTTXW
M W    X
B M    W
B M   DW
W M   DW
W M    W
W1W  2 W
W W WWWW
W W    W
W WWWW W
W      W
WWWWWWWW