WBBWTTXW
M  W   X
M  M   W
M  M  DW
W  M  DW
W  M   W
W 1  2 W
WWWWWWWW